111111111111111111111111111111
100000000000000000000000000001
100000000000000000000000000001
100011110000000000001000000001
100000000000000000001000000001
100000000000000000001000000001
100011110000000000001000000001
100000000000000000000000000001
100000000000000000000000000001
100000000011000011000000000001
100000000010000001000000000001
100000000010000000000000000001
100000000010011000000000000001
100000000010011000000000000001
100000000010000000000000000001
100000000010000001000000000001
100000000011000011000000000001
111111111111111111111111111111